18-7
......STTT........
..O...OTTT..S.....
....T..T..........
................SS
@......T........SS
.......TTT........
..................