8-5
.S.TT..S
.O.TT..C
....T..T
..@....C
C......S
